1111111111111
1001CCC0000C1
1001C11111X01
1P0000E000001
1111111111111