11111111111111111111111111
1E0000000000000C0000000011
10100101001000001010000011
10100100101010100010000011
1P0000000C00C0000000000011
11111111111111111111111111