1111111111111
1001CCC0P00C1
1000C11111001
1P0011E000001
1111111111111