1111111111111
1001CCC0F00C1
1001C11111001
1P0000E000001
1111111111111