1111111111111
1001CCC0000C1
1001C11111001
1P0000E000000
1111111111111